[
  { "id": 79 },
  { "id": 80 },
  { "id": 81 },
  { "id": 82 },
  { "id": 83 },
  { "id": 84 },
  { "id": 85 },
  { "id": 86 },
  { "id": 87 },
  { "id": 88 },
  { "id": 89 },
  { "id": 90 },
  { "id": 91 },
  { "id": 92 },
  { "id": 93 },
  { "id": 94 },
  { "id": 95 },
  { "id": 96 },
  { "id": 97 },
  { "id": 98 },
  { "id": 99 }
]